aapp;enzy	enzy
aapp;bacs;phsu	aapp
orch;phsu	phsu
bacs;phsu	bacs
bacs;orch;phsu	phsu
aapp;enzy;phsu	enzy
aapp;bacs	aapp
aapp;enzy;imft	imft
imft;phsu	imft
aapp;rcpt	rcpt
aapp;phsu	aapp
irda;phsu	irda
bacs;irda;orch	irda
irda;orch;phsu	irda
hops;orch	hops
hops;orch;phsu	orch
aapp;imft	imft
aapp;imft;rcpt	rcpt
bacs;orch	bacs
horm;orch;phsu	horm
irda;orch	irda
aapp;enzy;rcpt	rcpt
orch;phsu;vita	vita
aapp;bacs;irda	aapp
aapp;imft;irda	imft
aapp;enzy;irda	enzy
bacs;nnon	nnon
antb;orch	antb
orch;vita	vita
aapp;horm	horm
aapp;horm;phsu	horm
gngm;nnon	gngm
aapp;imft;phsu	imft
bacs;nnon;phsu	nnon
nnon;phsu	nnon
hops;irda	irda
imft;orch;phsu	imft
horm;phsu;vita	vita
aapp;antb	antb
food;orch	food
aapp;irda	irda
imft;orch	imft
horm;phsu	horm
irda;nnon	nnon
aapp;bacs;hops	hops
food;orch;phsu	food
bacs;hops	hops
aapp;hops	aapp
bacs;hops;orch	hops
imft;irda	imft
bacs;irda;nnon	nnon
cgab;dsyn	dsyn
horm;orch	horm
phsu;vita	vita
aapp;enzy;hops	hops
cell;phsu	cell
food;phsu	food
hops;irda;orch	irda
aapp;hops;phsu	phsu
hops;phsu	phsu
aapp;horm;irda	aapp
orch;rcpt	rcpt
imft;rcpt	rcpt
imft;nnon;phsu	imft
aapp;hops;imft	imft
aapp;nnon;phsu	aapp
hops;imft;orch	imft
antb;nnon	antb
imft;irda;orch	imft
bacs;irda	irda
antb;bacs;nnon	antb
aapp;enzy;nnon	enzy
aapp;irda;phsu	phsu
aapp;bacs;nnon	aapp
antb;bacs;orch	bacs
aapp;phsu;vita	phsu
nnon;phsu;vita	phsu
antb;irda;orch	irda
aapp;nnon	aapp
imft;irda;phsu	phsu
aapp;imft;irda;phsu	phsu
aapp;antb;nnon	antb
nnon;vita	nnon
